16
4444444444444444
4444444444444444
3333333333333333
3333333333333333
2222222222222222
2222222222222222
1111111111111111
1111111111111111
0000111111110000
0000        0000
2222        1111
2222        1111
3333333333333333