16
2222222222222222

0000000000000000
2112211221122112
4444444444444444
  004444444400

1111111111111111

1111333344441111
4444222233334444