16
0000000222220000   
0000002222220000   
0000022111220000   
0000221111220000   
0002211111220000  
0022222222220000   
0222222222220000   
0000000002220000   
0000000002220000
0000000002220000