16
4444444444444444
1010101010101010
2121212121212121
3232323232323232
4343434343434343
0404040404040404
1111111111111111
0000000000000000
1122        3344
1122        3344
1122        3344
0044 0    0 2211